BBBBBBBBBBBBBBBBBBBBBBBBBBBBBBBBBBB
...................................
...................................
...................................
...................................
.BBBBBBBBBBBBB.....................
...................................
...................................
...................................
...................................
....@..............................
BBBBBBBBBBBBBBBBBBBBBBBBBBBBBBBBBBB
