BBBBBBBBBBBBBBBBBBBBBBBBBBBBBBBBBBB
B.................................B
B.................................B
B.................................B
B.................................B
BBBBBBBBBBBBBB....................B
B.................................B
B.................................B
B.................................B
B.................................B
B...@.............................B
BBBBBBBBBBBBBBBBBBBBBBBBBBBBBBBBBBB
