CCCCCCCCCCCCCCCCCCCCCCCCCCCCCCCCCCCCCCCCCCCCCCCCCCCCCCCCCCCCCCCCCCCCCCCCCCCCCCCCCCCCCCCCCCCCCCCCCCCCCCCCCCCCCCCCCCCCCCCCCCCCCCCCCCCCCCCCCCCCCCCCCCCCCCCCCCCCCCCCCCCCCCCCCCCCCCCCCCCCCCCCCCCCCCCCCCCCCCCCCC
CCCCCCCCCCCCCCCCCCCCCCCCCCCCCCCCCCCCCCCCCCCCCCCCCCCCCCCCCCCCCCCCCCCCCCCCCCCCCCCCCCCCCCCCCCCCCCCCCCCCCCCCCCCCCCCCCCCCCCCCCCCCCCCCCCCCCCCCCCCCCCCCCCCCCCCCCCCCCCCCCCCCCCCCCCCCCCCCCCCCCCCCCCCCCCCCCCCCCCCCCC
WWWW..................................................................................................................................................................................................WWWW
WWWW..................................................................................................................................................................................................WWWW
WWWW..................................................................................................................................................................................................WWWW
WWWW..................................................................................................................................................................................................WWWW
WWWW..................................................................................................................................................................................................WWWW
WWWW..................................................................................................................................................................................................WWWW
WWWW..................................................................................................................................................................................................WWWW
WWWW..................................................................................................................................................................................................WWWW
WWWW..................................................................................................................................................................................................WWWW
WWWW..................................................................................................................................................................................................WWWW
WWWW..................................................................................................................................................................................................WWWW
WWWW..................................................................................................................................................................................................WWWW
WWWW..................................................................................................................................................................................................WWWW
WWWW..................................................................................................................................................................................................WWWW
WWWW..................................................................................................................................................................................................WWWW
WWWW..................................................................................................................................................................................................WWWW
WWWW.......@..........................................................................................................................................................................................WWWW
WWWW..................................................................................................................................................................................................WWWW
WWWW..........................GGGGGGGGGGGGGGGGGGGGGGGGG...............................................................................................................................................WWWW
WWWW..........................GGGGGGGGGGGGGGGGGGGGGGGGGGGGGGG.........................................................................................................................................WWWW
WWWWGGGGGGGGGGGGGGGGGGGGGGGGGGGGGGGGGGGGGGGGGGGGGGGGGGGGGGGGGGGGGG........................GGGGGGGGGGGGGGGGGGGGGGGGGGGGGGGGGGGGGGGGGGGGGGGGGGGGGGGGGGGGGGGGGGGGGGGGGGGGGGGGGGGGGGGGGGGGGGGGGGGGGGGGGGGGWWWW
WWWWGGGGGGGGGGGGGGGGGGGGGGGGGGGGGGGGGGGGGGGGGGGGGGGGGGGGGGGGGGGGGG.....................GGGGGGGGGGGGGGGGGGGGGGGGGGGGGGGGGGGGGGGGGGGGGGGGGGGGGGGGGGGGGGGGGGGGGGGGGGGGGGGGGGGGGGGGGGGGGGGGGGGGGGGGGGGGGGGWWWW
WWWWGGGGGGGGGGGGGGGGGGGGGGGGGGGGGGGGGGGGGGGGGGGGGGGGGGGGGGGGGGGGGGGGGGG.............GGGGGGGGGGGGGGGGGGGGGGGGGGGGGGGGGGGGGGGGGGGGGGGGGGGGGGGGGGGGGGGGGGGGGGGGGGGGGGGGGGGGGGGGGGGGGGGGGGGGGGGGGGGGGGGGGGWWWW
WWWWGGGGGGGGGGGGGGGGGGGGGGGGGGGGGGGGGGGGGGGGGGGGGGGGGGGGGGGGGGGGGGGGGGGGGGGGGGGGGGGGGGGGGGGGGGGGGGGGGGGGGGGGGGGGGGGGGGGGGGGGGGGGGGGGGGGGGGGGGGGGGGGGGGGGGGGGGGGGGGGGGGGGGGGGGGGGGGGGGGGGGGGGGGGGGGGGGGWWWW