CCCCCCCCCCCCCCCCCCCCCCCCCCCCCCCCCCCCCCCCCCCCCCCCCCCCCCCCCCCCCCCCCCCCCCCCCCCCCCCCCCCCCCCCCCCCCCCCCCCCC
WCCCCCCCCCCCCCCCCCCCCCCCCCCCCCCCCCCCCCCCCCCCCCCCCCCCCCCCCCCCCCCCCCCCCCCCCCCCCCCCCCCCCCCCCCCCCCCCCCCCW
WW.................................................................................................WW
WW.................................................................................................WW
WW..............................................................................................GGGWW
WW..............................................................................................GGGWW
WW.................................................................................................WW
WW................................................................................GGGGGGGGG........WW
WW........................................GGGGGGGGGGGG.............................................WW
WW........................................................................GGGGGG...................WW
WW...@......................GGGGGGGGGG.............................................................WW
WW..........................GGGGGGGGGG........................GGGGGGGG.............................WW
WWGGGGGGGGGGGGGGGGGGGGGGGGGGGGGGGGGGGGGGGGGGGGGGGGGGGGGGGGGGGGGGGGGGGGGGGGGGGGGGGGGGGGGGGGGGGGGGGGGWW
GGGGGGGGGGGGGGGGGGGGGGGGGGGGGGGGGGGGGGGGGGGGGGGGGGGGGGGGGGGGGGGGGGGGGGGGGGGGGGGGGGGGGGGGGGGGGGGGGGGGG